5,5
XSXXX
X   X
X XXX
X X X
XXXEX