5,5
XSXXX
X X X
X   X
X X X
XXXEX